==========================================================================
==========================================================================
==========================================================================
|  s                              |                                      |
|                                 |                                      |
|====================             |                                      |
|                                                                        |
|                                                             *          |
|                  ===================                                   |
|                                                                        |
|                                                                        |
|                                                                        |
|                *                    ==========================         |
|                                                                        |
|                                                                        |
|                                               |                        |
|================================               |                        |
|                                               |                        |
|                     *                         |                        |
|                                               |                        |
|                                               |                        |
|                                               |                       *|
==========================================================================
